Tran Date,Chq No,Particulars,Debit,Credit,Balance,Init. Br
2024-04-01,123456,Rent Payment,25000.00,,150000.00,175000.00
2024-04-02,,Salary Credit,,75000.00,225000.00,
2024-04-03,,Grocery Store,3200.50,,221799.50,
2024-04-04,555555,Utility Bill,2450.00,,219349.50,
2024-04-05,,Movie Night,1200.00,,218149.50,
2024-04-06,,Stock Dividend,,5000.00,223149.50,
2024-04-07,987654,Travel Booking,8500.00,,214649.50,
2024-04-08,,Freelance Payment,,15000.00,229649.50,
